institute,inst,country,bc,bsth,ts,os,cs,total
DIAS,104,DK,9,19,0,0,0,28
ADAS-RR,202,UK,0,63,46,0,0,109
ARDC,203,CA,7,0,0,0,0,7
AT,204,DK,0,10,0,7,0,17
AU,205,DK,0,53,0,11,9,73
AU,205,NL,0,0,0,1,0,1
CAU-LU,206,DE,0,9,0,0,0,9
INH-HAFL,207,CH,27,12,5,1,0,45
INRAE,208,FR,10,21,1,0,0,32
MU,209,IT,6,0,0,0,0,6
NMI-WUR,210,NL,8,0,0,0,0,8
TEAGASC,212,IE,8,18,23,0,0,49
WUR,214,NL,141,0,88,99,4,332
UNIMI,304,IT,4,0,0,0,0,4
UNINA,305,IT,2,0,0,0,0,2
Total,total,total,222,205,163,119,13,722
